1,1,1,1,1, 1,1,1,1,1, 1,1,1,1,1, 1,1,1,1,1, 1,1,1,1,1, 1,1,1,1,1, 1,1,
1,1,1,0,0, 0,0,0,0,0, 0,0,0,1,1, 1,1,1,1,0, 0,0,0,0,0, 0,0,0,0,1, 1,1,
1,1,0,0,5, 0,5,0,0,0, 0,0,0,10,10, 1,1,10,10,0, 0,0,0,0,0, 5,0,5,0,0, 1,1,
1,0,0,0,0, 0,0,0,0,0, 0,0,0,15,10, 10,10,10,15,0, 0,0,0,0,0, 0,0,0,0,0, 0,1,
1,0,0,0,10, 0,0,0,0,0, 0,0,0,0,0, 10,10,0,0,0, 0,0,0,0,0, 0,0,10,0,0, 0,1,

1,0,0,0,0, 0,0,0,0,0, 0,0,0,0,0, 0,0,0,0,0, 0,0,0,0,0, 0,0,0,0,0, 0,1,
1,1,0,5,0, 0,0,0,0,0, 0,0,0,0,0, 0,0,0,0,0, 0,0,0,0,0, 0,0,0,5,0, 1,1,
1,1,0,0,0, 0,0,0,0,0, 0,0,0,0,0, 1,1,0,0,0, 0,0,0,0,0, 0,0,0,0,0, 1,1,
1,1,1,0,0, 0,0,0,0,0, 0,0,0,0,1, 1,1,1,0,0, 0,0,0,0,0, 0,0,0,0,1, 1,1,
1,1,1,0,0, 0,0,0,0,0, 0,0,0,0,1, 1,1,1,0,0, 0,0,0,0,0, 0,0,0,0,1, 1,1,

1,1,0,0,0, 0,0,0,0,0, 0,0,0,0,0, 1,1,0,0,0, 0,0,0,0,0, 0,0,0,0,0, 1,1,
1,1,0,5,0, 0,0,0,0,0, 0,0,0,0,0, 0,0,0,0,0, 0,0,0,0,0, 0,0,0,5,0, 1,1,
1,0,0,0,0, 0,0,0,0,0, 0,0,0,0,0, 0,0,0,0,0, 0,0,0,0,0, 0,0,0,0,0, 0,1,
1,0,0,0,10, 0,0,0,0,0, 0,0,0,0,0, 10,10,0,0,0, 0,0,0,0,0, 0,0,10,0,0, 0,1,
1,0,0,0,0, 0,0,0,0,0, 0,0,0,15,10, 10,10,10,15,0, 0,0,0,0,0, 0,0,0,0,0, 0,1,

1,1,0,0,5, 0,5,0,0,0, 0,0,0,10,10, 1,1,10,10,0, 0,0,0,0,0, 5,0,5,0,0, 1,1,
1,1,1,0,0, 0,0,0,0,0, 0,0,0,1,1, 1,1,1,1,0, 0,0,0,0,0, 0,0,0,0,1, 1,1,
1,1,1,1,1, 1,1,1,1,1, 1,1,1,1,1, 1,1,1,1,1, 1,1,1,1,1, 1,1,1,1,1, 1,1